75
95
13 13 13 13 13 13 13 13 13 13 13 13 13 13 13 13 13 13 13 13 13 13 13 13 13 13 13 13 13 13 13 13 13 13 13 13 13 13 13 13 13 13 13 13 13 13 13 13 13 13 13 13 13 13 13 13 13 13 13 13 13 13 13 13 13 13 13 13 13 13 13 13 13 13 13 13 13 13 13 13 13 13 13 13 13 13 13 13 13 13 13 13 13 13 13
13 13 13 13 13 13 13 13 13 13 13 13 13 13 13 13 13 13 13 13 13 13 13 13 13 13 13 13 13 13 13 13 13 13 13 13 13 13 13 13 13 13 13 13 13 13 13 13 13 13 13 13 13 13 13 13 13 13 13 13 13 13 13 13 13 13 13 13 13 13 13 13 13 13 13 13 13 13 13 13 13 13 13 13 13 13 13 13 13 13 13 13 13 13 13
13 13 11 11 11 11 11 11 11 11 11 11 11 11 15 15 11 11 11 11 11 11 11 11 11 11 11 18 11 11 11 11 11 11 11 11 11 11 11 11 11 16 16 13 13 13 13 11 19 19 11 11 11 11 11 11 11 19 11 11 11 11 11 11 11 11 11 11 11 11 11 11 18 11 11 11 11 11 11 11 11 11 11 13 13 13 13 11 11 11 11 17 17 13 13
13 13 11 11 11 11 11 11 11 11 11 11 11 11 15 15 11 11 11 11 11 11 11 11 11 11 11 11 11 11 11 11 11 11 11 11 11 11 11 11 11 16 16 13 13 13 13 11 19 19 11 11 11 11 11 11 11 11 11 11 11 11 11 11 11 11 11 11 11 11 11 11 11 11 11 11 11 11 11 11 11 11 11 13 13 13 13 11 11 11 11 17 17 13 13
13 13 11 11 11 11 11 11 11 11 11 11 11 11 11 11 11 11 11 11 11 11 11 11 11 11 11 11 11 11 11 11 11 11 11 11 11 11 11 11 11 11 11 13 13 13 13 11 11 11 11 11 11 11 11 11 11 11 11 11 11 11 11 11 11 11 11 11 11 11 11 11 11 11 11 11 11 11 11 11 11 11 11 13 13 13 13 16 11 11 11 11 11 13 13
13 13 11 11 11 17 11 11 11 11 11 11 11 11 11 11 11 11 11 11 11 11 11 11 11 11 11 11 11 11 11 11 11 11 11 11 11 11 11 11 11 11 11 13 13 13 13 11 11 11 11 11 11 11 11 11 11 11 11 11 11 11 11 11 11 11 11 11 11 11 11 11 11 11 11 11 11 11 11 11 11 16 16 13 13 13 13 11 11 11 11 11 11 13 13
13 13 11 11 11 11 11 11 11 11 11 11 11 11 11 11 11 11 11 11 11 11 11 11 11 11 11 11 11 11 11 11 11 11 11 11 11 11 11 11 11 11 11 13 13 13 13 11 11 11 11 11 11 11 11 11 11 11 11 11 11 11 11 11 11 11 11 11 11 11 11 11 11 11 11 11 11 11 11 11 11 16 16 13 13 13 13 11 11 11 11 11 11 13 13
13 13 13 13 13 13 13 13 13 13 13 13 13 13 13 13 13 13 13 13 13 13 13 13 13 13 13 11 11 11 11 11 11 13 13 13 13 11 11 11 11 11 11 13 13 13 13 11 11 11 11 11 11 13 13 13 13 13 13 13 13 13 13 13 13 13 13 13 13 13 13 13 13 13 13 13 13 13 13 13 13 13 13 13 13 13 13 11 11 11 11 11 11 13 13
13 13 13 13 13 13 13 13 13 13 13 13 13 13 13 13 13 13 13 13 13 13 13 13 13 13 13 11 11 11 11 11 11 13 13 13 13 11 11 11 11 11 11 13 13 13 13 11 11 11 11 11 11 13 13 13 13 13 13 13 13 13 13 13 13 13 13 13 13 13 13 13 13 13 13 13 13 13 13 13 13 13 13 13 13 13 13 11 11 11 11 11 11 13 13
13 13 13 13 13 13 13 13 13 13 13 13 13 13 13 13 13 13 13 13 13 13 13 13 13 13 13 11 11 11 11 15 15 13 13 13 13 11 11 11 11 11 11 13 13 13 13 11 11 11 11 11 11 13 13 13 13 13 13 13 13 13 13 13 13 13 13 13 13 13 13 13 13 13 13 13 13 13 13 13 13 13 13 13 13 13 13 11 11 11 11 11 11 13 13
13 13 12 12 12 19 19 12 12 12 12 16 12 12 12 12 12 12 12 12 16 16 12 12 12 12 12 12 12 12 12 15 15 13 13 13 13 12 12 12 12 12 12 12 12 12 12 12 12 12 12 12 12 13 13 13 13 12 12 17 17 12 12 12 12 12 12 12 12 12 12 12 12 12 12 18 18 12 12 12 12 12 17 17 12 12 12 12 12 12 12 12 12 13 13
13 13 12 12 12 19 19 12 12 12 12 12 12 12 12 12 12 12 12 12 16 16 12 12 12 12 12 12 12 12 12 12 12 13 13 13 13 12 12 12 12 12 12 12 12 12 12 19 12 12 12 12 12 13 13 13 13 12 12 17 17 12 12 12 12 12 12 12 12 12 12 18 12 12 12 18 18 12 12 12 12 12 17 17 12 12 12 12 12 12 12 12 12 13 13
13 13 12 12 12 12 12 12 12 12 12 12 12 12 12 12 12 12 12 12 12 12 12 12 12 12 12 12 12 12 12 12 12 13 13 13 13 12 12 12 12 12 12 12 12 12 12 12 12 12 12 12 12 13 13 13 13 12 12 12 12 12 12 12 12 12 12 12 12 12 12 12 12 12 12 12 12 12 12 12 12 12 12 12 12 12 12 12 12 12 12 12 12 13 13
13 13 12 12 12 12 12 12 12 12 12 12 12 12 12 12 12 12 12 12 12 12 12 12 12 12 12 12 12 12 16 12 12 13 13 13 13 12 12 12 12 12 12 12 12 12 12 12 12 12 12 12 12 13 13 13 13 12 12 12 12 12 12 12 12 12 12 12 12 12 12 12 12 12 12 12 12 12 12 12 12 12 12 12 12 12 12 12 12 12 12 12 12 13 13
13 13 12 12 12 12 12 12 12 12 12 12 12 15 15 12 12 12 12 12 12 12 12 12 12 12 12 12 12 12 12 12 12 13 13 13 13 12 12 18 12 12 12 12 12 12 12 12 12 12 12 17 17 13 13 13 13 12 12 12 12 12 12 12 12 19 19 12 12 12 12 12 12 12 12 12 12 12 12 12 12 12 12 12 12 12 12 12 12 12 12 19 19 13 13
13 13 12 12 12 12 12 12 12 19 12 12 12 15 15 12 12 12 12 12 12 12 12 12 12 12 12 12 12 12 12 12 12 13 13 13 13 12 12 12 12 12 12 18 12 12 12 12 12 12 12 17 17 13 13 13 13 12 12 12 12 12 12 12 12 19 19 12 12 12 12 12 12 12 12 12 12 12 12 12 12 12 12 12 12 12 12 12 12 12 12 19 19 13 13
13 13 13 13 13 13 13 13 13 13 13 13 13 13 13 13 13 12 12 12 12 12 12 13 13 13 13 12 12 12 12 12 12 13 13 13 13 13 13 13 13 13 13 13 13 13 13 13 13 13 13 13 13 13 13 13 13 13 13 13 13 13 13 13 13 13 13 16 12 12 12 12 12 13 13 13 13 13 13 13 13 13 13 13 13 13 13 12 12 12 12 12 12 13 13
13 13 13 13 13 13 13 13 13 13 13 13 13 13 13 13 13 16 12 12 12 12 12 13 13 13 13 12 12 12 12 12 12 13 13 13 13 13 13 13 13 13 13 13 13 13 13 13 13 13 13 13 13 13 13 13 13 13 13 13 13 13 13 13 13 13 13 12 12 12 12 12 12 13 13 13 13 13 13 13 13 13 13 13 13 13 13 12 12 12 12 12 12 13 13
13 13 13 13 13 13 13 13 13 13 13 13 13 13 13 13 13 12 12 12 12 12 12 13 13 13 13 12 12 12 12 12 12 13 13 13 13 13 13 13 13 13 13 13 13 13 13 13 13 13 13 13 13 13 13 13 13 13 13 13 13 13 13 13 13 13 13 12 12 12 12 12 12 13 13 13 13 13 13 13 13 13 13 13 13 13 13 12 12 12 12 12 12 13 13
13 13 11 11 11 11 11 11 11 11 19 11 11 11 11 11 11 11 11 11 11 11 11 13 13 13 13 11 11 11 11 11 11 11 11 11 11 11 11 11 11 11 11 11 11 11 11 11 11 11 11 11 11 13 13 13 13 18 18 11 11 11 11 11 11 17 11 11 11 11 11 11 11 11 11 11 11 11 11 11 11 16 16 13 13 13 13 11 11 11 11 11 15 13 13
13 13 17 17 11 11 11 11 11 11 11 11 11 11 11 11 11 11 11 11 11 19 19 13 13 13 13 11 11 11 19 11 11 11 11 11 11 11 11 11 11 11 11 11 11 11 11 11 18 16 11 11 11 13 13 13 13 18 18 11 11 11 11 11 11 11 11 11 11 11 11 11 11 11 19 11 11 11 11 11 11 16 16 13 13 13 13 11 11 11 11 11 11 13 13
13 13 17 17 11 11 11 11 11 11 11 11 11 11 11 11 11 11 11 11 11 19 19 13 13 13 13 11 11 11 11 11 11 11 11 11 11 11 11 11 11 11 11 11 11 11 11 11 18 16 11 11 11 13 13 13 13 11 11 11 11 11 11 11 11 11 11 11 11 11 11 11 11 11 11 11 11 11 11 11 11 11 11 13 13 13 13 11 11 11 11 11 11 13 13
13 13 11 11 11 11 11 11 11 11 11 11 11 11 11 11 11 11 11 11 11 11 11 13 13 13 13 11 11 11 11 11 11 11 11 11 11 11 11 11 11 11 11 11 11 11 11 11 11 11 11 11 11 13 13 13 13 11 11 11 11 11 11 11 11 11 11 11 11 11 11 11 11 11 11 11 11 11 11 11 11 11 11 13 13 13 13 11 11 11 11 11 11 13 13
13 13 11 11 11 11 11 11 11 11 11 11 11 11 19 11 11 11 11 11 11 11 11 13 13 13 13 11 11 11 11 11 11 11 11 11 11 11 11 11 11 11 11 11 11 11 11 11 11 11 11 11 11 13 13 13 13 11 11 11 11 11 11 11 15 11 11 11 11 11 11 11 11 11 11 11 11 11 11 11 11 17 11 13 13 13 13 11 11 11 11 11 11 13 13
13 13 11 11 11 11 11 11 13 13 13 13 13 13 13 13 13 11 11 11 11 11 11 13 13 13 13 13 13 13 13 13 13 13 13 13 13 13 13 13 13 13 13 13 13 13 13 13 13 13 13 13 13 13 13 13 13 11 11 11 11 11 11 13 13 13 13 13 13 13 13 13 13 13 13 13 13 11 11 11 11 11 11 13 13 13 13 17 17 11 11 11 11 13 13
13 13 11 16 11 11 11 11 13 13 13 13 13 13 13 13 13 11 11 11 11 11 11 13 13 13 13 13 13 13 13 13 13 13 13 13 13 13 13 13 13 13 13 13 13 13 13 13 13 13 13 13 13 13 13 13 13 11 11 11 11 11 11 13 13 13 13 13 13 13 13 13 13 13 13 13 13 11 11 11 11 11 11 13 13 13 13 17 17 11 11 11 11 13 13
13 13 11 11 11 11 11 11 13 13 13 13 13 13 13 13 13 11 11 11 11 11 11 13 13 13 13 13 13 13 13 13 13 13 13 13 13 13 13 13 13 13 13 13 13 13 13 13 13 13 13 13 13 13 13 13 13 11 11 11 11 11 11 13 13 13 13 13 13 13 13 13 13 13 13 13 13 11 11 11 11 11 11 13 13 13 13 11 11 11 11 11 11 13 13
13 13 12 12 12 12 12 12 12 16 12 12 12 13 13 13 13 15 12 12 12 12 12 13 13 13 13 18 18 12 12 12 12 13 13 13 13 12 12 12 15 15 12 12 12 12 12 12 12 19 19 12 12 12 12 12 12 12 12 12 12 12 12 13 13 13 13 12 12 12 12 12 12 13 13 13 13 16 12 12 12 12 12 13 13 13 13 12 12 12 12 12 12 13 13
13 13 12 12 12 12 12 12 12 12 12 12 12 13 13 13 13 12 12 12 12 12 12 13 13 13 13 18 18 12 12 12 12 13 13 13 13 12 12 12 15 15 12 12 12 12 12 12 12 19 19 12 12 12 12 12 12 12 12 12 12 12 12 13 13 13 13 12 12 12 12 12 12 13 13 13 13 12 12 12 12 12 12 13 13 13 13 12 12 12 12 12 12 13 13
13 13 12 12 12 12 12 12 12 12 12 16 19 13 13 13 13 13 12 12 12 12 15 13 13 13 13 12 12 12 12 12 12 13 13 13 13 12 12 12 12 12 12 12 12 12 12 12 12 12 12 12 12 12 12 12 12 12 12 12 12 12 12 13 13 13 13 12 12 12 18 19 12 13 13 13 13 12 12 12 12 12 12 13 13 13 13 12 12 12 12 12 12 13 13
13 13 12 12 12 12 12 12 12 16 12 16 19 13 13 13 13 13 12 12 12 12 12 13 13 13 13 12 12 12 12 12 12 13 13 13 13 12 12 12 12 12 12 12 12 12 12 12 12 12 12 12 12 12 12 12 12 12 12 12 12 12 12 13 13 13 13 12 12 12 18 19 12 13 13 13 13 12 12 12 12 12 12 13 13 13 13 12 12 12 12 12 12 13 13
13 13 12 12 12 12 12 12 12 16 12 12 12 13 13 13 13 13 12 12 12 12 12 13 13 13 13 12 12 12 12 12 12 13 13 13 13 12 12 12 12 12 12 12 12 12 12 12 12 12 12 12 12 12 12 12 12 12 12 12 12 18 18 13 13 13 13 12 12 12 12 12 12 13 13 13 13 12 12 17 17 12 12 13 13 13 13 12 12 12 12 12 12 13 13
13 13 15 15 12 12 12 12 12 16 12 12 12 13 13 13 13 13 12 12 12 12 12 13 13 13 13 12 12 12 12 12 12 13 13 13 13 12 12 12 12 12 12 12 12 12 12 12 12 19 19 12 12 12 12 12 12 12 12 12 12 18 18 13 13 13 13 12 12 12 12 12 12 13 13 13 13 12 12 17 17 12 12 13 13 13 13 12 12 12 12 12 12 13 13
13 13 15 15 12 12 12 12 13 13 13 13 13 13 13 13 13 12 12 12 12 12 12 13 13 13 13 12 12 12 12 12 12 13 13 13 13 12 12 12 12 12 13 13 13 13 13 13 13 13 13 13 13 13 13 13 13 13 13 13 13 13 13 13 13 13 13 12 12 12 12 12 12 13 13 13 13 13 13 13 13 13 13 13 13 13 13 12 12 12 12 12 12 13 13
13 13 12 12 12 12 12 12 13 13 13 13 13 13 13 13 13 12 12 12 12 12 12 13 13 13 13 12 12 12 12 12 12 13 13 13 13 12 12 12 12 12 13 13 13 13 13 13 13 13 13 13 13 13 13 13 13 13 13 13 13 13 13 13 13 13 13 12 12 12 12 12 12 13 13 13 13 13 13 13 13 13 13 13 13 13 13 12 12 12 12 12 12 13 13
13 13 12 12 12 12 12 12 13 13 13 13 13 13 13 13 13 13 13 12 12 12 12 13 13 13 13 12 12 12 12 12 12 13 13 13 13 12 12 12 12 12 13 13 13 13 13 13 13 13 13 13 13 13 13 13 13 13 13 13 13 13 13 13 13 13 13 12 12 12 12 12 12 13 13 13 13 13 13 13 13 13 13 13 13 13 13 12 12 12 12 12 12 13 13
13 13 11 11 11 11 11 11 13 13 13 13 16 11 11 11 11 13 13 11 11 11 11 11 11 11 11 11 11 11 11 11 11 13 13 13 13 11 11 11 11 11 11 13 13 13 13 11 17 19 11 11 11 13 13 13 13 11 11 11 11 11 11 11 11 16 11 11 11 11 11 11 11 11 11 11 11 11 11 11 11 11 11 11 18 18 11 11 11 11 11 11 11 13 13
13 13 11 11 11 11 11 11 13 13 13 13 11 11 11 11 11 11 11 11 11 11 11 11 11 11 11 11 11 11 11 11 11 13 13 13 13 19 11 11 11 11 11 13 13 13 13 11 17 19 11 11 11 13 13 13 13 11 11 11 11 11 11 11 11 11 11 11 11 11 11 11 11 11 11 11 11 11 11 11 11 11 11 11 18 18 11 11 11 11 11 11 11 13 13
13 13 11 11 11 11 11 11 13 13 13 13 11 11 11 11 11 11 11 11 11 11 11 11 11 11 11 11 11 11 11 11 11 13 13 13 13 11 11 11 11 11 11 13 13 13 13 11 11 11 11 11 11 13 13 13 13 15 18 11 11 11 11 11 11 11 11 11 11 11 11 11 11 11 11 11 11 11 11 11 11 11 11 11 11 11 11 11 11 11 11 11 11 13 13
13 13 11 11 11 11 11 11 13 13 13 13 11 11 11 11 11 11 11 11 11 11 11 11 11 11 11 11 11 16 19 11 11 13 13 13 13 11 11 11 11 11 11 13 13 13 13 11 11 11 11 11 11 13 13 13 13 15 18 11 11 11 11 11 11 11 11 11 11 11 11 11 11 11 11 11 11 11 11 11 11 11 11 11 11 11 11 11 11 11 11 11 11 13 13
13 13 11 11 11 11 11 11 13 13 13 13 11 11 11 11 11 11 11 11 11 11 11 11 11 11 11 11 11 16 19 11 11 13 13 13 13 11 11 11 11 11 11 13 13 13 13 11 11 11 11 11 11 13 13 13 13 11 11 11 11 11 11 11 11 11 11 11 11 11 11 11 11 11 11 11 17 17 11 11 11 11 11 11 11 11 11 11 11 11 11 18 11 13 13
13 13 11 11 11 11 11 11 13 13 13 13 11 11 11 11 11 13 13 13 13 13 13 13 13 13 13 13 13 13 13 13 13 13 13 13 13 13 11 11 11 11 11 13 13 13 13 11 11 11 11 11 11 13 13 13 13 11 11 11 11 11 11 13 13 13 13 11 11 11 11 11 11 13 13 13 13 13 13 13 13 13 13 13 13 13 13 11 11 11 11 11 11 13 13
13 13 11 11 11 11 11 11 13 13 13 13 11 11 11 11 11 13 13 13 13 13 13 13 13 13 13 13 13 13 13 13 13 13 13 13 13 13 11 11 11 11 11 13 13 13 13 11 11 11 11 11 11 13 13 13 13 11 11 11 11 11 11 13 13 13 13 11 11 11 11 11 19 13 13 13 13 13 13 13 13 13 13 13 13 13 13 11 11 11 11 11 11 13 13
13 13 11 11 11 11 11 11 13 13 13 13 11 11 11 11 11 13 13 13 13 13 13 13 13 13 13 13 13 13 13 13 13 13 13 13 13 13 11 11 11 11 11 13 13 13 13 11 11 11 11 11 11 13 13 13 13 11 11 11 11 11 11 13 13 13 13 11 11 11 11 11 11 13 13 13 13 13 13 13 13 13 13 13 13 13 13 11 11 11 11 11 11 13 13
13 13 12 12 12 12 12 12 13 13 13 13 12 12 12 12 12 13 13 13 13 12 12 16 12 12 12 12 12 12 19 12 12 12 12 12 12 12 12 12 12 12 12 12 12 15 12 12 12 12 12 12 12 13 13 13 13 12 12 12 12 12 12 13 13 13 13 12 12 12 12 12 12 12 12 12 12 19 19 12 12 15 18 13 13 13 13 12 12 12 12 12 12 13 13
13 13 12 12 12 12 12 12 13 13 13 13 12 12 12 12 12 13 13 13 13 12 12 12 12 12 12 12 12 12 12 12 12 12 12 12 12 12 12 12 12 12 12 12 12 12 12 12 12 12 12 12 12 13 13 13 13 12 12 12 12 12 12 13 13 13 13 12 12 12 12 12 12 12 12 12 12 19 19 12 12 15 18 13 13 13 13 12 12 12 12 12 15 13 13
13 13 12 12 12 12 12 12 13 13 13 13 12 12 12 12 12 13 13 13 13 12 12 12 12 12 12 12 12 12 12 12 12 12 12 12 12 12 12 12 12 12 12 12 12 12 12 12 12 12 12 12 18 13 13 13 13 12 12 12 12 12 12 13 13 13 13 12 12 12 12 12 12 12 12 12 12 12 12 12 12 12 12 13 13 13 13 12 12 12 12 12 12 13 13
13 13 12 12 12 12 12 12 13 13 13 13 12 12 12 12 12 13 13 13 13 12 12 12 12 12 12 12 12 12 12 12 12 12 12 12 12 12 12 12 12 12 12 12 12 12 12 12 12 12 12 12 12 13 13 13 13 12 12 12 12 12 12 13 13 13 13 12 12 16 16 12 12 12 12 12 12 12 12 12 12 12 12 13 13 13 13 12 19 12 12 12 12 13 13
13 13 12 12 12 12 12 12 13 13 13 13 12 12 12 12 12 13 13 13 13 12 12 12 12 12 12 12 12 12 12 12 12 12 12 12 16 12 12 12 12 12 12 16 12 12 12 12 12 16 12 12 12 13 13 13 13 12 12 12 12 12 12 13 13 13 13 12 12 16 16 12 12 17 12 12 12 12 12 12 12 12 16 13 13 13 13 12 12 12 12 12 12 13 13
13 13 12 12 12 12 19 12 13 13 13 13 12 12 12 12 12 13 13 13 13 17 12 12 12 12 12 13 13 13 13 13 13 13 13 13 13 13 13 13 13 13 13 13 13 13 13 13 13 13 13 13 13 13 13 13 13 12 12 12 12 12 19 13 13 13 13 13 13 13 13 13 13 13 13 13 13 12 12 12 12 12 12 13 13 13 13 13 13 13 13 13 13 13 13
13 13 12 12 12 12 12 12 13 13 13 13 12 12 12 12 12 13 13 13 13 12 12 12 12 12 12 13 13 13 13 13 13 13 13 13 13 13 13 13 13 13 13 13 13 13 13 13 13 13 13 13 13 13 13 13 13 12 12 12 12 12 12 13 13 13 13 13 13 13 13 13 13 13 13 13 13 12 12 12 12 12 12 13 13 13 13 13 13 13 13 13 13 13 13
13 13 12 12 12 12 12 12 13 13 13 13 12 12 12 12 12 13 13 13 13 12 12 12 12 12 12 13 13 13 13 13 13 13 13 13 13 13 13 13 13 13 13 13 13 13 13 13 13 13 13 13 13 13 13 13 13 12 12 12 12 12 12 13 13 13 13 13 13 13 13 13 13 13 13 13 13 12 12 12 12 12 12 13 13 13 13 13 13 13 13 13 13 13 13
13 13 11 11 11 11 11 11 11 11 11 11 11 11 11 11 11 13 13 13 13 11 11 11 11 11 11 13 13 13 13 18 11 11 11 11 11 11 11 11 11 11 11 13 13 13 13 14 14 14 14 14 14 14 14 14 14 14 14 14 14 14 14 14 14 14 14 14 14 14 14 14 14 14 14 14 14 14 14 14 14 14 14 14 14 14 14 14 14 14 14 14 14 13 13
13 13 11 11 11 11 11 11 11 11 11 11 11 11 11 11 11 13 13 13 13 11 11 11 11 11 11 13 13 13 13 11 11 11 11 11 11 11 11 11 11 11 11 13 13 13 13 14 14 14 14 14 14 14 14 14 14 14 14 14 14 14 14 14 14 14 14 14 14 14 14 14 14 14 14 14 14 14 14 14 14 14 14 14 14 14 14 14 14 14 14 14 14 13 13
13 13 15 11 11 11 11 11 11 11 11 11 11 11 11 11 11 13 13 13 13 11 11 11 11 19 11 13 13 13 13 11 11 11 11 11 11 11 11 11 16 16 11 13 13 13 13 14 14 14 14 14 14 14 14 14 14 14 14 14 14 14 14 14 14 14 14 14 14 14 14 14 14 14 14 14 14 14 14 14 14 14 14 14 14 14 14 14 14 14 14 14 14 13 13
13 13 11 11 11 11 11 11 11 11 11 11 11 11 11 11 11 13 13 13 13 11 11 11 11 11 11 13 13 13 13 11 11 11 11 11 11 11 11 11 16 16 11 13 13 13 13 14 14 14 14 14 14 14 14 14 14 14 14 14 14 14 14 14 14 14 14 14 14 14 14 14 14 14 14 14 14 14 14 14 14 14 14 14 14 14 14 14 14 14 14 14 14 13 13
13 13 11 11 11 11 11 11 11 11 11 11 11 11 11 11 11 13 13 13 13 11 11 11 11 11 11 13 13 13 13 11 11 11 11 11 11 11 11 11 11 11 11 13 13 13 13 14 14 14 14 14 14 14 14 14 14 14 14 14 14 14 14 14 14 14 14 14 14 14 14 14 14 14 14 14 14 14 14 14 14 14 14 14 14 14 14 14 14 14 14 14 14 13 13
13 13 11 11 11 11 11 11 13 13 13 13 11 11 11 11 11 13 13 13 13 11 11 11 11 11 11 13 13 13 13 13 13 13 13 13 11 11 11 11 11 11 11 13 13 13 13 14 14 14 14 14 14 14 14 14 14 14 14 14 14 14 14 14 14 14 14 14 14 14 14 14 14 14 14 14 14 14 14 14 14 14 14 14 14 14 14 14 14 14 14 14 14 13 13
13 13 11 11 11 11 11 11 13 13 13 13 11 11 11 11 11 13 13 13 13 11 11 11 11 11 11 13 13 13 13 13 13 13 13 13 11 11 11 11 11 11 11 13 13 13 13 14 14 14 14 14 14 14 14 14 14 14 14 14 14 14 14 14 14 14 14 14 14 14 14 14 14 14 14 14 14 14 14 14 14 14 14 14 14 14 14 14 14 14 14 14 14 13 13
13 13 11 11 11 11 11 11 13 13 13 13 11 11 11 11 11 13 13 13 13 11 11 11 11 11 11 13 13 13 13 13 13 13 13 13 17 11 11 11 11 11 11 13 13 13 13 14 14 14 14 14 14 14 14 14 14 14 14 14 14 14 14 14 14 14 14 14 14 14 14 14 14 14 14 14 14 14 14 14 14 14 14 14 14 14 14 14 14 14 14 14 14 13 13
13 13 12 12 12 12 12 12 13 13 13 13 12 12 12 12 12 13 13 13 13 12 12 12 12 12 12 12 12 12 12 12 13 13 13 13 12 12 12 12 12 18 12 13 13 13 13 14 14 14 14 14 14 14 14 14 14 14 14 14 14 14 14 14 14 14 14 14 14 14 14 14 14 14 14 14 14 14 14 14 14 14 14 14 14 14 14 14 14 14 14 14 14 13 13
13 13 12 12 12 12 12 12 13 13 13 13 12 12 12 12 12 13 13 13 13 12 12 12 12 12 12 12 12 12 12 12 13 13 13 13 12 12 12 12 12 12 12 13 13 13 13 14 14 14 14 14 14 14 14 14 14 14 14 14 14 14 14 14 14 14 14 14 14 14 14 14 14 14 14 14 14 14 14 14 14 14 14 14 14 14 14 14 14 14 14 14 14 13 13
13 13 12 12 12 12 15 12 13 13 13 13 12 12 12 12 12 13 13 13 13 12 12 12 12 12 12 12 12 12 12 12 13 13 13 13 12 12 12 12 12 12 12 13 13 13 13 14 14 14 14 14 14 14 14 14 14 14 14 14 14 14 14 14 14 14 14 14 14 14 14 14 14 14 14 14 14 14 14 14 14 14 14 14 14 14 14 14 14 14 14 14 14 13 13
13 13 12 12 12 12 12 12 13 13 13 13 12 12 12 12 12 13 13 13 13 12 12 12 12 12 12 12 12 12 12 12 13 13 13 13 12 12 12 12 12 12 12 13 13 13 13 14 14 14 14 14 14 14 14 14 14 14 14 14 14 14 14 14 14 14 14 14 14 14 14 14 14 14 14 14 14 14 14 14 14 14 14 14 14 14 14 14 14 14 14 14 14 13 13
13 13 12 12 12 12 12 12 13 13 13 13 12 12 12 12 12 13 13 13 13 12 12 12 12 12 12 12 12 12 12 12 13 13 13 13 12 12 12 12 18 12 12 13 13 13 13 14 14 14 14 14 14 14 14 14 14 14 14 14 14 14 14 14 14 14 14 14 14 14 14 14 14 14 14 14 14 14 14 14 14 14 14 14 14 14 14 14 14 14 14 14 14 13 13
13 13 12 12 12 12 12 12 13 13 13 13 12 12 12 12 12 13 13 13 13 13 13 13 13 13 13 12 12 12 12 12 13 13 13 13 12 12 12 12 12 12 12 13 13 13 13 14 14 14 14 14 14 14 14 14 14 14 14 14 14 14 14 14 14 14 14 14 14 14 14 14 14 14 14 14 14 14 14 14 14 14 14 14 14 14 14 14 14 14 14 14 14 13 13
13 13 12 12 12 12 12 12 13 13 13 13 12 12 12 12 12 13 13 13 13 13 13 13 13 13 13 12 12 12 12 12 13 13 13 13 12 12 12 12 12 12 12 13 13 13 13 14 14 14 14 14 14 14 14 14 14 14 14 14 14 14 14 14 14 14 14 14 14 14 14 14 14 14 14 14 14 14 14 14 14 14 14 14 14 14 14 14 14 14 14 14 14 13 13
13 13 12 12 12 12 12 12 13 13 13 13 12 12 12 12 12 13 13 13 13 13 13 13 13 13 13 12 12 12 12 12 13 13 13 13 12 12 12 12 12 12 12 13 13 13 13 14 14 14 14 14 14 14 14 14 14 14 14 14 14 14 14 14 14 14 14 14 14 14 14 14 14 14 14 14 14 14 14 14 14 14 14 14 14 14 14 14 14 14 14 14 14 13 13
13 13 11 11 11 11 11 11 13 13 13 13 11 11 11 11 11 11 11 15 11 11 11 11 18 11 11 11 11 11 11 11 11 15 11 11 11 11 11 11 11 11 11 13 13 13 13 14 14 14 14 14 14 14 14 14 14 14 14 14 14 14 14 14 14 14 14 14 14 14 14 14 14 14 14 14 14 14 14 14 14 14 14 14 14 14 14 14 14 14 14 14 14 14 14
13 13 11 11 11 11 11 11 13 13 13 13 11 11 11 11 11 11 11 11 11 11 11 11 11 11 11 11 11 11 11 11 11 11 11 11 11 11 11 11 11 11 11 13 13 13 13 14 14 14 14 14 14 14 14 14 14 14 14 14 14 14 14 14 14 14 14 14 14 14 14 14 14 14 14 14 14 14 14 14 14 14 14 14 14 14 14 14 14 14 14 14 14 14 14
13 13 16 19 11 11 11 11 13 13 13 13 11 11 11 11 11 11 11 11 11 11 11 11 11 11 11 11 11 11 11 11 11 11 11 11 11 11 11 11 11 11 11 13 13 13 13 14 14 14 14 14 14 14 14 14 14 14 14 14 14 14 14 14 14 14 14 14 14 14 14 14 14 14 14 14 14 14 14 14 14 14 14 14 14 14 14 14 14 14 14 14 14 14 14
13 13 16 19 11 11 11 11 13 13 13 13 17 19 11 11 11 11 11 11 11 11 11 11 11 11 11 11 11 11 11 11 11 11 11 11 11 11 15 18 11 11 11 13 13 13 13 14 14 14 14 14 14 14 14 14 14 14 14 14 14 14 14 14 14 14 14 14 14 14 14 14 14 14 14 14 14 14 14 14 14 14 14 14 14 14 14 14 14 14 14 14 14 14 14
13 13 11 11 11 11 11 11 13 13 13 13 17 19 11 11 11 11 11 11 11 11 11 11 11 11 11 11 15 11 11 11 11 11 11 11 11 11 18 15 11 11 11 13 13 13 13 14 14 14 14 14 14 14 14 14 14 14 14 14 14 14 14 14 14 14 14 14 14 14 14 14 14 14 14 14 14 14 14 14 14 14 14 14 14 14 14 14 14 14 14 14 14 14 14
13 13 13 13 13 13 13 13 13 13 13 13 13 13 13 13 13 13 13 13 13 13 13 13 13 13 13 13 13 13 13 13 13 13 13 13 13 13 13 13 13 13 13 13 13 13 13 13 13 13 13 13 13 13 13 13 13 13 13 13 13 13 13 13 13 13 13 13 13 13 13 13 13 13 13 13 13 13 13 13 13 13 13 13 13 13 13 13 13 13 13 13 13 13 13
13 13 13 13 13 13 13 13 13 13 13 13 13 13 13 13 13 13 13 13 13 13 13 13 13 13 13 13 13 13 13 13 13 13 13 13 13 13 13 13 13 13 13 13 13 13 13 13 13 13 13 13 13 13 13 13 13 13 13 13 13 13 13 13 13 13 13 13 13 13 13 13 13 13 13 13 13 13 13 13 13 13 13 13 13 13 13 13 13 13 13 13 13 13 13